1000 80
1000 1
1 1 998 0 1 1
1 1 998 0 1 1
1 1 998 0 1 1
1 1 998 0 1 1
1 1 998 0 1 1
1 1 998 0 1 1
1 1 998 0 1 1
1 1 998 0 1 1
1 1 998 0 1 1
1 1 998 0 1 1
1 1 998 0 1 1
1 1 998 0 1 1
1 1 998 0 1 1
1 1 998 0 1 1
1 1 998 0 1 1
1 1 998 0 1 1
1 1 998 0 1 1
1 1 998 0 1 1
1 1 998 0 1 1
1 1 998 0 1 1
1 1 998 0 1 1
1 1 998 0 1 1
1 1 998 0 1 1
1 1 998 0 1 1
1 1 998 0 1 1
1 1 998 0 1 1
1 1 998 0 1 1
1 1 998 0 1 1
1 1 998 0 1 1
1 1 998 0 1 1
1 1 998 0 1 1
1 1 998 0 1 1
1 1 998 0 1 1
1 1 998 0 1 1
1 1 998 0 1 1
1 1 998 0 1 1
1 1 998 0 1 1
1 1 998 0 1 1
1 1 998 0 1 1
1 1 998 0 1 1
1 1 998 0 1 1
1 1 998 0 1 1
1 1 998 0 1 1
1 1 998 0 1 1
1 1 998 0 1 1
1 1 998 0 1 1
1 1 998 0 1 1
1 1 998 0 1 1
1 1 998 0 1 1
1 1 998 0 1 1
1 1 998 0 1 1
1 1 998 0 1 1
1 1 998 0 1 1
1 1 998 0 1 1
1 1 998 0 1 1
1 1 998 0 1 1
1 1 998 0 1 1
1 1 998 0 1 1
1 1 998 0 1 1
1 1 998 0 1 1
1 1 998 0 1 1
1 1 998 0 1 1
1 1 998 0 1 1
1 1 998 0 1 1
1 1 998 0 1 1
1 1 998 0 1 1
1 1 998 0 1 1
1 1 998 0 1 1
1 1 998 0 1 1
1 1 1 10 997 0 1 1
1 1 998 0 1 1
1 1 998 0 1 1
1 1 998 0 1 1
1 1 990 0 1 12 7 0 1 1
1 1 998 0 1 1
1 1 998 0 1 1
1000 1
1 1 998 0 1 1
1 1 998 0 1 1
1 1 998 0 1 1

