1000 40
1 1 998 0 1 1
1 1 998 0 1 1
1 1 998 0 1 1
1 1 998 0 1 1
1 1 998 0 1 1
1 1 998 0 1 1
1 1 998 0 1 1
1 1 998 0 1 1
1 1 998 0 1 1
1 1 998 0 1 1
1 1 998 0 1 1
1 1 998 0 1 1
1 1 998 0 1 1
1 1 998 0 1 1
1 1 998 0 1 1
1 1 998 0 1 1
5 1 1 10 15 0 969 0 1 1
1 1 998 0 1 1
1 1 998 0 1 1
1 1 998 0 1 1
1 1 498 0 1 11 499 0 1 1
1 1 998 0 1 1
1 1 998 0 1 1
1 1 990 0 1 12 7 0 1 1
1 1 998 0 1 1
1 1 998 0 1 1
1 1 998 0 1 1
1 1 998 0 1 1
20 1 20 0 20 1 20 0 20 1 100 1 100 0 100 1 200 0 100 1 300 0
1 1 998 0 1 1
1 1 998 0 1 1
1 1 998 0 1 1
1 1 998 0 1 1
1 1 998 0 1 1
1 1 998 0 1 1
1 1 998 0 1 1
1 1 998 0 1 1
1 1 998 0 1 1
1 1 998 0 1 1


